NO Assets/Tester Textures/simonkraft/wet_sponge.xpm
SO Assets/Tester Textures/simonkraft/wet_sponge.xpm
WE Assets/Tester Textures/simonkraft/wet_sponge.xpm
EA Assets/Tester Textures/simonkraft/wet_sponge.xpm

F 164,169,20
C 153,204,255

111
101
101111111111
110000000001
11N000000111
110000000001
110000000001
110000000001
111111111111