NO Assets/Tester Textures/test/north.xpm
SO Assets/Tester Textures/test/south.xpm
WE Assets/Tester Textures/test/west.xpm
EA Assets/Tester Textures/test/east.xpm

F 20,20,20
C 200,200,200

11111111
10000001
10000001
10000001
10000001
10000001
110N0001
10000001
10000001
10000001
10000001
10000001
11111111
